name:Map 2
width:100
height:27
startx:2
starty:6
;
XXXXXXXXXXXXXXXXXXXXXXXXXXXXXXXXXXXXXXXXXXXXXXXXXXXXXXXXXXXXXXXXXXXXXXXXXXXXXXXXXXXXXXXXXXXXXXXXXXXX
X                                                                                                  X
X                                                                                                  X
X                                                                                                  X
X                                                                                                  X
X                                                                                                  X
X                                                                                                  X
X                                                                                                  X
X                                                                                                  X
X                                                                                                  X
X                                                                                                  X
X                                                                                                  X
X                                                                                                  X
X                                                          XXXXXXXXXXXX                            X
X                                                                                                  X
X                                              XXXXXXXXXXXXXX                                      X
X                                                                                                  X
X                XXXXXXXXXXXXXX              W               XXXXXX                 W              X
X           W  XX                        XXXXXXXXX                                XXXXXXXXXXXXXXXXXX
X          XXXX                    W W                 W  W  W               XXXXXXXXXX            X
X                                XXXXXXXX         XXXXXXXXXXXXXXXXXXXXXXXX                         X
XXXXXXXXXXX                                                        XXXXX                           X
X                                      XXXXXXXXXXXXXXXXXXXXXXXXXXXX                                X
X                                                                                                  X
X                                                                                                  X
X                                                                                                  X
XXXXXXXXXXXXXXXXXXXXXXXXXXXXXXXXXXXXXXXXXXXXXXXXXXXXXXXXXXXXXXXXXXXXXXXXXXXXXXXXXXXXXXXXXXXXXXXXXXXX